                                         
                                         
                                         
                                         
    #############                         
    #...........#                         
    #...........#                         
    #...........#                         
    #...........#                         
    #...........#                         
    #...........#                         
    #...........#                         
    #...........######################    
    #................................#    
    #................................>    
    #................................#    
    #...........######################    
    #...........#                         
    #...........#                         
    #...........#                         
    #...........#                         
    #...........#                         
    #...........#                         
    #...........#                         
    ######>######                         
                                         
                                         
                                         
                                         